1111111111
10K0000L01
1111101111
1000101001
11101L1K11
1010101011
101K100001
1010101111
10L000L001
1111111111