11111111
10010001
12010001
11000111
12010031
11110111
13000001
11111111