11111111
10012001
12010031
11000111
12010001
11113111
13020001
11111111