1111111111111111111111111
1000000000000000030000001
1011111111111111111111101
1010000000000000000010101
1010101111111111101010101
1010101000000000101010101
1012101011111110101010101
1010101000102310101310101
1010101110101110101010101
1010100010100000101010101
1110111010111111101110101
1003001010000000020000001
1011111011111111111111101
1010000000000200100000001
1111111111111111111111111